#########
#G#     #
# #C# P #
# # # # #
#    C# #
#       #
#G#######
 #