##########
#G#  ##  #
# # C    #
# # ##   #
#    P## #
#        #  
##########