  #######
 #   ☼○##
 #   ☼  #
 #‼     #
 #‼ ###G#
### # #G#
# C # #G#
# CC# ###
#P  #    
#####    