#######
#G    #
# #C# #
# # # #
# # # #
#P#   #
#######