##########
##########
#######  #
### G# #G#
#     G  #
# #  C C #
# #####  #
##### CCG#
### P    #
##########