##########
# GP######
#CC#######
#  #######
#  #######
# ########
#   ######
#GC  G####
# G C ####
##########